WWWWWWWWWWWWWWWWWWWWW
WGGDDDDDDDDDDWDDDDDDW
WGGDDDDDSDDDDDD*DDDDW
WWWWWWWWWWWWWWWDWDDDW
WGDDDD*DDDDDDDWWWDDDW
WDDDDDDDDDDDD*DDDDDDW
WDDWWWWWWWWWWWWWWWWWW
WDDDDGGDDDDDDDDDDDDFW
WWWWWWWWWWWWWWWWWWWWW