WWWWWWWWWWWWWWWWWWWWWWWWWWWWWWWWWWWWWW
WBDDDDWDWDDDDDDDDDDDDDDDDDDDDDDDDDDDSW
WGDDDDW*DDDDD*DDDDDD*DDDDDD*DDDDDD*DDW
WDDDDDDDWDDDDDDDDDDDDDDDDDDDDDDDDDDDDW
WDDWWWWWWWWWWWWWWWWWWWWWWWWWWWWWWWWWWW
WDDDDDDDDDDWDDDDDDDDDDDDDDDDDDDDDDDGGW
WDDDDDDDDDDBDDDDDDDDDDDDDDDGDDDDDDDDDW
WDDDDDDDDDDBGDDDDDDDDDDDDDDDDDDDDDGGGW
WWWWWWWWWWWWWWWWWWWWWWWWWWWWWWWWWWWDDW
WDDDDDDDDDDDDDDDD*DDDDDDDDDDGDDDDDDDDW
WDDDDDDD*DDDWBDDDDWWWWDD*DGDDDDDDDDDDW
WDDDDDDDDDDDWGGWBDDGGWDDDDDDDD*DDDDDDW
WDDWWWWWWWWWWWWWWWWWWWWWWWWWWWWWWWWWWW
WDBDDDWDDDDDDDDDDDDWDDDDDDDDDDWDDDDDGW
WDDDDDWGGGGGGGGGGGGWDDDDDDDDDDWBDDDDDW
WDDDDDWBBBBBBBBBBBBWDDDDDDDDDDBGGDDDDW
WDBDDDWDDDDDDDDDDDDWDDDDDDDDDDBDDDDDDW
WWGWDDDDDDDDDDDDDDDDDDDDDGGDDDDDDDDBDW
WWWWWWWWWWWWWWWWWWWWWWWWWWWWWWWWWWWBDW
WWWWDDD*DDDBDDDDDDDDDDDDDD*DDDDDDDDDDW
WFDDDWDDDDGBDDDDDDD*DDDDDDDDDDDGGDDDDW
WWWWWWWWWWWWWWWWWWWWWWWWWWWWWWWWWWWWWW