WWWWWWWWWWWWWWWWWWWW
WSDDBDDDDDDBBDDDDDDW
WDDDBBDDDDDBBBDDDDDW
WDDDBBDDDDDDDBDDDDDW
WWWWWWWWWWWWWWWWWDDW
WDBBDDDDBDGDDDDGDDDW
WDGGDDDDDBGBDDDDBDDW
WDDDBDDDDDDDBDDDDDDW
WGGWWWWWWWWWWWWWWWWW
WDDDDDDDDDDDDDDDDDDW
WWBBDBBBDBBBDBBDBBDW
WDDDDDDDDDDDDDDDDDDW
WDWWWWWWWWWWWWWWWWWW
WDDDDDDDDDDDDDDGDDFW
WWWWWWWWWWWWWWWWWWWW