WWWWWWWWWWWWWWWWWWWWWWWWWWWWWWWWWWWWWW
WWWWWWWWWBBDDDDDDDDDDBDDDDDGGDDDDDDDDW
WSDDDDDDDDDDWWWDDDDBDDDDDDDBDDDDDDDBDW
WWWWWWWWWWWWWWWWWWWWWWWWWWWWWWWWWWWBDW
WDDBGDDDDDBBDDDWDGBDDDGDDDBDDDDDDDDDDW
WDDGDDDDDDDDDDDWBBDD*DDDDDGBDDDDDDDDDW
WDDDDDDDDDBDDDDDDDDDDDDDDDDBDDDDDDDDDW
WWDWWWWWWWWWWWWWWWWWWWWWWWWWWWWWWWWWWW
WDDDDDDDDDDDBGDDDDDDBDDDBDDDDDDDBDDDDW
WDBBDDDDDDDDBBBDDDDDBDDDBDDDDDDDBDDDBW
WDGDDDDDDDDDDDDDDDDDDDDDDBDDDDDDGDDDDW
WDBDDDDDDDDDWWDDDDDDDDDDDBDDDDDDDDDDDW
WWWWWWWWWWWWWWWWWWWWWWWWWWWWWWWWWWWWGW
WFDDDDDDDBGBDDDDDDDWDDDDDGBDDDDDDDDDDW
WWWBDDDDDBBBDDDDDDDWDDDDDDDDDDDDDDDDDW
WGDDDDDDDDDDDDBDDDDWDWWWWWWWWWWWWWWWWW
WBBBDDDDBDDDDDBDDDDWDBBDDDDDDDGDDDDGDW
WWWWDDDGDDDDDDDDDDGWDDGDDDDDDDGGGDDDDW
WGGBDDDDDDDDDDDDDBBWWWWWWWWWWWWWWWWW*W
WGGBDDDDDDDDDDDDDDDDDDDDDDDDDDDDDDDDDW
WWWWWWWWWWWWWWWWWWWWWWWWWWWWWWWWWWWWWW