WWWWWW
WSGBDW
WDDBDW
WDDDDW
WDDDFW
WWWWWW