WWWWWWWWWWWWWW
WSDDBDBDDDBBDW
WBDDBDBDDDDDDW
WWWWWWWWWWWDDW
WBDDDBDBBDDDDW
WDDDDBDDDDDDDW
WDDWWWWWWWWWWW
WGGBDDDDDDBDDW
WDDDDDDDDDBDFW
WWWWWWWWWWWWWW