WWWWWWWWWWWWWWWWWWWWW
WDDDDDDDDDDDDDDDDDDDW
WDDDDDDSDDDDDDDDDDDDW
WDDDDDDDDDDDDDDDDDDDW
WDDDDDDDDDDDDDDDDDDDW
WDDDDDDDDDDDD*DDDDDDW
WDDDDDDDDDDDDDDDDDDDW
WDDDDDDDDDDDDDDDDDDDW
WWWWWWWWWWWWWWWWWWWWW