WWWWWW
WSDBDW
WDDBDW
WDDDDW
WDDDFW
WWWWWW