WWWWWW
WSDDDW
WBDDBW
WDDDDW
WDDBFW
WWWWWW