WWWWWWW
WBDDDDW
W DDDDW
WSDDDFW
WWWWWWW